+++++++++++++++++++
+a                +
+              ++++
+                 +
+              ++A+
+              0+ +
+++++++++++++++++++
