+++++++++++++++++
+      + b+     +
+      + B+     +
+      +  +     +
+      +  +aA  1+
+      +  ++    +
+        0      +
+++++++++++++++++
