+++++++++++++++++++
+0              Bb+
+                 +
+                 +
+                 +
+1              Aa+
+++++++++++++++++++
