+++++++++++++++++
+0     + b+    1+
+      + B+     +
+      +  +     +
+      +  +aA   +
+      +  ++    +
+               +
+++++++++++++++++
