+++++++++++++++++
+0     + b+     +
+      + B+     +
+      +  +     +
+      +  +aA   +
+      +  ++    +
+1              +
+++++++++++++++++
