+++++++++++++++++++
+0                +
+1             ++++
+                 +
+              ++A+
+               +a+
+++++++++++++++++++
