+++++++++
+  ++ A +
+0 B   a+
+  ++   +
+++++++++
          