+++++++++
+  ++   +
+0 B A a+
+  ++   +
+++++++++
          