+++++++++++++++++++++++++++++++++++++++++++++++++++++++++++++++++++
+         +     +     +                                           +
+  ++++   +  +  +  +  +  +++++++++++++++++++++++++++++++++++++++  +
+  ++++   +  +  +  +  +     +a  +                                 +
+  ++++   +  +  +  +  +  +  +++ +  ++++++++++++++++++++++++++++++++
+  ++++   +  +  +  +  +  +      +                                 +
+  ++++   +  +  +  +  +  +++++++++++++++++++++++++++++++++++++++  +
+  ++++      +     +     ++0                                      +
+ +++++++++++++++++++++++++++++++++++++++++++++++++++++++++++++++++
+                                         + A     +               +
++++++++++++++++++++++++++++++++++++++++  + A  +  +   aaa         +
+                                         + A  +  +   aba         +
+  ++++++++++++++++++++++++++++++++++++++++ A  +  +   aaa         +
+                                         + A  +  +               +
++++++++++++++++++++++++++++++++++++++++  + A  +  ++++++++CDEFGHIJ+
+                                         + A  +  +               +
+  ++++++++++++++++++++++++++++++++++++++++ A  +  +               +
+                                         + A  +  +               +
++++++++++++++++++++++++++++++++++++++++  + B  +  +               +
+                                         + A  +  +               +
+  ++++++++++++++++++++++++++++++++++++++++ A  +  +               +
+                                         + A  +  +               +
++++++++++++++++++++++++++++++++++++++++  + B  +  +               +
+                                         + A  +  +               +
+  ++++++++++++++++++++++++++++++++++++++++ A  +  +               +
+                                           A  +                  +
+++++++++++++++++++++++++++++++++++++++++++++++++++++++++++++++++++
