+++++++++++++++++++++++++++++++++++++++++++++++++++++++++++++++++++
+         +     +     +                                           +
+  ++++QQQ+  +  +  +  +  +++++++++++++++++++++++++++++++++++++++  +
+  ++++   +  +  +  +  +     +a  +                                 +
+  ++++   +  +  +  +  +  +  +++ +  ++++++++++++++++++++++++++++++++
+  ++++   +  +  +  +  +  +      +                                 +
+  ++++   +  +  +  +  +  +++++++++++++++++++++++++++++++++++++++  +
+  ++++      +  Q  +     ++0                                      +
+ +++++++++++++++++++++++++++++++++++++++++++++++++++++++++++++++++
+                                         + A     +   a a a       +
++++++++Q+++++++++++++++++++++++++++++++  + A  +  +    a b a      +
+                                         + A  +  +     a a a     +
+  ++++++++++++++++++Q+++++++++++++++++++++ A  +  +               +
+                                         + A  +  +               +
++++++++++++++++++++++++++++++++++++++++  + A  +  ++++++++CDEFGHIJ+
+                                         + A  +  +               +
+  ++++++++++++++++++++++++++++++++++++++++ A  +  +               +
+                                         + A  +  +               +
++++++++++++++++++++++++++Q+++++++++++++  + B  +  +               +
+                                         + A  +  +               +
+  ++++++++++++++++++++++++++++++++++++++++ A  +  +               +
+                                         + A  +  +               +
++++++++Q+++++++++++++++++++++++++++++++  + B  +  +               +
+                                         + A  +  +               +
+  ++++++++++++++++++++++++++++++++++++++++ A  +  +               +
+                                           A  +                  +
+++++++++++++++++++++++++++++++++++++++++++++++++++++++++++++++++++
