++++++++
+ 0 + a+
+  G+  +
+  F+B +
+  E+CA+
+      +
++++++++