++++++++
+  0+a +
+  G+A +
+  F+B +
+  E+C +
+      +
++++++++